###########
##A  ##  B#
## ####  ##
##   ##  ##
#### ## ###
##       ##
###########
